+--+--+--+--+--+--+--+--+--+--+--+--+--+--+--+--+--+--+--+--+--+--+--+--+--+--+--+--+--+--+--+--+--+--+--+--+--+--+--+--+
|  |        |              |  |                       |              |        |     |        |     |                    |
+  +  +--+  +  +--+--+--+  +  +  +--+--+--+  +--+--+  +--+  +  +--+--+  +--+  +  +  +  +--+  +  +  +  +--+  +--+  +--+--+
|     |  |  |  |        |  |  |     |        |     |     |  |  |        |  |     |     |  |  |  |        |  |     |     |
+--+--+  +  +  +--+  +--+  +  +--+  +  +--+--+  +--+--+  +  +--+  +--+--+  +--+--+--+--+  +  +  +--+--+--+  +  +--+  +  +
|  |        |  |     |     |     |  |     |  |           |        |        |              |  |  |     |     |     |  |  |
+  +  +--+--+  +  +  +  +--+  +--+  +--+  +  +  +--+--+--+--+--+  +  +  +  +--+--+--+  +--+  +  +--+  +  +--+--+--+  +  +
|  |     |     |  |  |     |        |     |     |              |  |  |  |           |     |     |     |     |        |  |
+  +--+  +  +  +  +--+--+  +--+--+--+  +--+  +--+--+  +--+--+  +  +--+  +--+--+--+  +--+  +--+--+  +--+--+  +  +--+--+  +
|  |     |  |  |        |        |     |  |  |        |  |     |        |        |  |        |           |     |     |  |
+  +  +--+--+  +  +--+  +--+--+  +  +--+  +  +  +--+--+  +  +--+--+--+--+  +--+  +  +  +--+  +--+--+--+  +--+--+  +  +  +
|     |        |     |  |     |     |     |     |  |     |  |        |        |  |  |  |  |  |     |        |     |     |
+  +--+  +--+--+--+  +  +  +  +--+--+  +  +--+--+  +  +  +  +--+  +  +--+--+  +  +  +  +  +  +  +  +  +--+  +  +--+--+  +
|  |     |     |     |     |     |     |        |     |  |     |  |     |  |  |        |        |     |     |     |     |
+  +  +--+  +  +  +--+--+--+--+  +  +--+--+  +  +  +--+  +--+  +  +--+  +  +  +--+--+--+--+--+--+--+--+--+--+--+  +  +--+
|     |     |  |        |        |  |     |  |  |     |        |  |  |  |        |              |     |           |     |
+--+--+  +--+--+--+--+  +  +--+  +  +  +  +  +--+--+  +--+--+--+  +  +  +--+--+--+  +--+--+--+  +  +  +  +--+--+--+--+  +
|     |                 |  |     |     |  |        |  |     |     |  |              |        |     |     |        |     |
+  +--+  +--+--+--+--+--+  +--+--+--+--+  +--+--+  +  +  +--+  +  +  +--+--+--+--+--+  +--+--+--+--+--+--+  +--+--+  +--+
|     |     |        |     |           |     |  |     |        |  |                 |     |     |        |        |  |  |
+  +  +--+  +--+--+  +  +--+  +--+--+  +--+  +  +--+--+--+--+--+  +  +--+  +--+--+  +--+  +  +  +  +--+  +  +--+  +  +  +
|  |     |        |  |  |     |        |  |  |                    |  |  |     |           |  |     |  |     |  |     |  |
+--+  +--+--+--+  +  +  +  +--+  +--+  +  +  +  +--+  +--+--+--+--+  +  +--+  +--+--+--+  +  +--+--+  +--+--+  +--+--+  +
|     |        |     |     |  |     |     |  |     |  |           |        |        |  |  |  |        |        |        |
+  +  +  +  +--+--+  +--+--+  +--+  +--+--+  +--+--+  +  +--+  +  +--+  +--+--+  +  +  +  +  +--+  +  +  +  +--+  +--+  +
|  |  |  |        |  |           |           |        |     |  |  |     |     |  |  |     |        |  |  |           |  |
+  +  +  +--+--+  +  +--+  +  +  +--+--+--+--+  +--+--+  +--+  +  +--+--+  +  +--+  +  +--+--+--+--+  +  +--+--+--+--+  +
|  |  |  |        |     |  |  |  |     |        |  |     |     |  |        |        |     |     |     |  |        |     |
+  +--+  +  +--+  +--+  +--+  +  +  +--+  +  +--+  +  +--+  +--+  +  +--+--+--+--+--+  +--+  +  +  +--+  +  +--+  +  +--+
|        |     |     |        |  |        |     |     |     |        |  |           |  |     |     |        |     |     |
+  +--+--+--+  +--+--+--+--+--+  +  +--+--+--+  +--+--+  +  +--+--+--+  +  +--+--+  +  +  +--+--+--+--+--+--+--+--+  +  +
|        |  |                    |     |     |  |        |  |     |              |     |  |  |        |           |  |  |
+--+--+  +  +--+--+--+--+--+--+--+--+  +  +  +  +  +--+  +--+  +  +--+--+--+--+--+  +--+  +  +  +  +  +  +--+--+  +--+  +
|     |        |           |  |     |     |  |  |     |  |     |  |        |     |     |  |     |  |     |     |     |  |
+  +--+--+--+  +  +--+--+  +  +  +  +--+  +--+  +--+  +--+  +--+  +  +--+  +  +  +--+--+  +--+--+  +--+--+--+  +--+  +  +
|  |           |        |  |     |        |     |     |     |  |     |     |  |        |        |  |              |  |  |
+  +  +--+--+--+--+--+  +  +  +--+--+--+--+  +--+  +  +  +--+  +--+--+  +--+  +--+--+  +--+--+  +  +  +  +--+--+--+  +  +
|  |  |              |  |  |     |        |  |     |  |  |           |     |  |  |           |     |  |  |           |  |
+  +  +  +--+--+--+  +  +  +--+--+  +--+  +  +  +--+--+  +--+--+  +  +--+  +  +  +  +--+--+--+--+--+  +--+  +--+--+--+  +
|        |              |           |        |                    |     |        |                                      |
+--+--+--+--+--+--+--+--+--+--+--+--+--+--+--+--+--+--+--+--+--+--+--+  +--+--+--+--+--+--+--+--+--+--+--+--+--+--+--+--+
