201201112201110112100
132221032212013031223
201320203032122011311
212022312113030310112
203320121120322013203
030131220213021320221
203020313120310203212
130331120122022312113
